111111111011
1P0000000E01
1CCCCCCCCCC1
111111111111