111111111111
1P000001ECC1
100000000D01
111111111111