1111111111
100000P111
11CCE00001
1111111111