111111111111111111111111111111111111111111111
1CE000000000000000000000000000000000000000001
100000000000000000000000000000000000000000001
100000000000000000000000000000000000000000001
10000000000000000000P000000000000000000000001
100000000000001100011100000000000000000000001
100000000000010100100010000000000000000000001
100000000000100100000100000000000000000000001
100000000001111110001000000000000000000000001
100000000000000100010000000000000000000000001
100000000000000100111110000000000000000000001
100000000000000000000000000000000000000000001
100000000000000C00000000000000000000000000001
1000000000000000C0000000000000000000000000001
100000000000000000000000000000000000000000001
100000000000000000C00000000000000000000000001
100000000000000000000000000000000000000000001
100000000000000000000000000000000000000000001
100000000000000000000000000000000000000000001
100000000000000000000000000000000000000000001
10000000000000CC000CCC00000000000000000000001
1000000000000C0C00C000C0000000000000000000001
100000000000C00C00000C00000000000000000000001
10000000000CCCCCC000C000000000000000000000001
100000000000000C000C0000000000000000000000001
100000000000000C00CCCCC0000000000000000000001
100000000000000000000000000000000000000000001
100000000000000000000000000000000000000000001
100000000000000000000000000000000000000000001
100000000000000000000000000000000000000000001
100000000000000000000000000000000000000000001
100000000000000000000000000000000000000000001
100000000000000000000000000000000000000000001
111111111111111111111111111111111111111111111